#Combined, base, tone
à	a	f
ả	a	r
ã	a	x
á	a	s
ạ	a	j
ă	aw	_
ằ	aw	f
ẳ	aw	r
ẵ	aw	x
ắ	aw	s
ặ	aw	j
â	aa	_
ầ	aa	f
ẩ	aa	r
ẫ	aa	x
ấ	aa	s
ậ	aa	j
è	e	f
ẻ	e	r
ẽ	e	x
é	e	s
ẹ	e	j
ê	ee	_
ề	ee	f
ể	ee	r
ễ	ee	x
ế	ee	s
ệ	ee	j
ì	i	f
ỉ	i	r
ĩ	i	x
í	i	s
ị	i	j
ò	o	f
ỏ	o	r
õ	o	x
ó	o	s
ọ	o	j
ô	oo	_
ồ	oo	f
ổ	oo	r
ỗ	oo	x
ố	oo	s
ộ	oo	j
ơ	ow	_
ờ	ow	f
ở	ow	r
ỡ	ow	x
ớ	ow	s
ợ	ow	j
ù	u	f
ủ	u	r
ũ	u	x
ú	u	s
ụ	u	j
ư	uw	_
ừ	uw	f
ử	uw	r
ữ	uw	x
ứ	uw	s
ự	uw	j
ỳ	y	f
ỷ	y	r
ỹ	y	x
ý	y	s
ỵ	y	j
đ	dd	_
