#声母拼音,声母名稱
p	幫
ph	滂
b	並
m	明
t	端
th	透
d	定
n	泥
tr	知
thr	徹
dr	澄
nr	娘
l	來
c	精
ch	清
z	從
s	心
zs	邪
cr	莊
chr	初
zr	崇
sr	生
zsr	俟
cj	章
chj	昌
zj	常
sj	書
zsj	船
nj	日
k	見
kh	谿
g	羣
ng	疑
h	曉
gh	匣
q	影
_	云	#拼作零声母
j	以
